NO ./textures/north.xpm
SO ./textures/south.xpm
WE ./textures/west.xpm
EA ./textures/east.xpm
F 255,248,220
C 135,206,235 // cyan


11111111111111111111111111111111111111111111111111
1N001000000010000000100000000100000000100000000001
1110111111010111111010111111010111111010111111011
1000100001010000001010000001010000001010000001001
1011101111011111011011111011011111011011111011011
1000001000000001010000001010000001010000001000001
1111101011111011011111011011111011011111011011111
1000001010000010000001010000001010000001010000001
1011111010111111011111010111111011111010111111011
1000000001000000010000001000000010000001000000011
1011111111011111111011111111011111111011111111011
1000000001000000010000000001000000010000000000001
1111111011111011111011111011111011111011111011111
1000001010000010000001010000001010000001010000001
1011111011111011111011111011111011111011111011111
1000000001000000000000010000000000000000000000001
1111111111011111111111011111111111011111111111111
1000000000000000000000000000000000000000000000001
1011111111111111111111111111111111111111111111011
1000000000000000000000000000000000000000000000001
1111111111111111111111111111111111111111111111111
1000000000000000000000000000000000000000000000001
1011111111111111111111111111111111111111111111011
1000000000000000000000000000000000000000000000001
1111111111111111111111111111111111111111111111111
1000000000000000000000000000000000000000000000001
1011111111111111111111111111111111111111111111011
1000000000000000000000000000000000000000000000001
1111111111111111111111111111111111111111111111111
1000000000000000000000000000000000000000000000001
1011111111111111111111111111111111111111111111011
1000000000000000000000000000000000000000000000001
1111111111111111111111111111111111111111111111111
1000000000000000000000000000000000000000000000001
1011111111111111111111111111111111111111111111011
1000000000000000000000000000000000000000000000001
1111111111111111111111111111111111111111111111111
1000000000000000000000000000000000000000000000001
1011111111111111111111111111111111111111111111011
1000000000000000000000000000000000000000000000001
1111111111111111111111111111111111111111111111111
1000000000000000000000000000000000000000000000001
1011111111111111111111111111111111111111111111011
1000000000000000000000000000000000000000000000001
1111111111111111111111111111111111111111111111111