1111111111111
1000000000001
1020000000201
10000W0000001
1020000000201
1000000000001
1111111111111